[
  {
    "method": "json",
    "om_terrain": [ [ "urban_5_1", "urban_5_2" ] ],
    "type": "mapgen",
    "object": {
      "fill_ter": "t_floor",
      "rows": [
        ".....p________...............``.................",
        ".....!________!..............``........[........",
        ".....!________`````````````````............[....",
        "..[..!________!..............``.................",
        ".....!________!.....%%%%....````.....%%%%.......",
        ".....!________....###oo#####o**o######oo###.....",
        ".....!________.!!!#T  sE        L|TE  rr R#^....",
        "....##========#####y      H      |R   h  R#.....",
        "....#'''''''''&#qq|x   l  H               o.....",
        "....#''''''''''+''|x   l  H      |y EsE RR#.....",
        "....o''''''''''#UU|x      H      |||||||||#.....",
        "....#''''''''''#|||y    E         <|B¨¨|zv#.....",
        "....#''''''''''#ZW|||JJJ||˙||  |||||B¨S|zQ#.....",
        "....#''''''''''+  +˙˙˙˙˙˙˙˙˙|  |S¨t|t¨¨| D#.....",
        "....o''''''''''#L>|˙˙000˙˙˙˙|  +¨¨¨|||+|+|#.....",
        "....#''''''''''#|||˙˙JJJ˙˙˙Y||+|||||R     #.....",
        "....#''''''''''#66|˙˙J5J˙˙˙7|             #.....",
        "...^###*########  +˙˙˙˙˙˙˙˙O|            d#.....",
        "....```````````#66|FF35n21˙4|T      ii    o.....",
        "...%```````````######ooo##*##Ih     @@   d#.....",
        "...%````````````````````````#IIIy   @@    #..[..",
        "...%```````````......%%%....####oo#########.....",
        "....```````````..u....%...................^.....",
        "................................................"
      ],
      "palettes": [
        "standard_domestic_palette",
        "parameterized_linoleum_color_kitchen",
        "parameterized_linoleum_color_bathroom",
        "standard_domestic_landscaping_palette"
      ],
      "terrain": {
        "&": "t_gates_mech_control",
        "=": "t_door_metal_locked",
        "#": "t_adobe_brick_wall",
        "'": "t_thconc_floor",
        "q": "t_thconc_floor",
        "U": "t_thconc_floor",
        "0": { "param": "linoleum_color_kitchen", "fallback": "t_linoleum_white" },
        "Y": { "param": "linoleum_color_kitchen", "fallback": "t_linoleum_white" },
        "Q": "t_floor",
        "6": "t_floor"
      },
      "furniture": { "0": "f_stool" },
      "place_loot": [ { "item": "stereo", "x": 19, "y": 9, "chance": 100 }, { "item": "television", "x": 19, "y": 9, "chance": 100 } ],
      "place_vehicles": [ { "vehicle": "suburban_home", "x": 10, "y": 13, "chance": 30, "rotation": 90 } ]
    }
  },
  {
    "method": "json",
    "om_terrain": [ [ "urban_5_3", "urban_5_4" ] ],
    "type": "mapgen",
    "object": {
      "fill_ter": "t_floor",
      "rows": [
        "~~~~~~~~~~~~~~~~~~~~~~~~~~~~~~~~~~~~~~~~~~~~~~~~",
        "~~~~~~~~~~~~~~~~~~~~~~~~~~~~~~~~~~~~~~~~~~~~~~~~",
        "~~~~~~~~~~~~~~~~~~~~~~~~~~~~~~~~~~~~~~~~~~~~~~~~",
        "~~~~~~~~~~~~~~~~~~~~~~~~~~~~~~~~~~~~~~~~~~~~~~~~",
        "~~~~~~~~~~~~~~~~~~~~~~~~~~~~~~~~~~~~~~~~~~~~~~~~",
        "~~~~~~~~~~~~~~~~~~-------------------------~~~~~",
        "~~~~~~~~~~~~~~~~~~-======#ooo#============%~~~~~",
        "~~~~-----------#####o#####TII##############~~~~~",
        "~~~~-==========#D   IIT R|R h  sd|D|8SS8¨B#~~~~~",
        "~~~~-==========o    h    |||     + |¨¨¨¨¨Bo~~~~~",
        "~~~~-==========o         + |   @@|||¨¨¨t¨¨#~~~~~",
        "~~~~-==========#db    @@|| |+|||||>|¨|||||#~~~~~",
        "~~~~-==========#|||||||||          +¨|RRRR#~~~~~",
        "~~~~-==========#Q |y s@@||||+||||+||||   T#~~~~~",
        "~~~~-==========#D +   @@      d|    b    Io~~~~~",
        "~~~~-==========#D |           d|s       hIo~~~~~",
        "~~~~-=========^#vQ|y  h   Es   |E  l     I#~~~~~",
        "~~~~%----------######III##########HHH######~~~~~",
        "~~~~~~~~~~~~~~~-====#ooo#========#ooo#====-~~~~~",
        "~~~~~~~~~~~~~~~--------------=============-~~~~~",
        "~~~~~~~~~~~~~~~~~~~~~~~~~~~~-=============-~~~~~",
        "~~~~~~~~~~~~~~~~~~~~~~~~~~~~--------------%~~~~~",
        "~~~~~~~~~~~~~~~~~~~~~~~~~~~~~~~~~~~~~~~~~~~~~~~~",
        "~~~~~~~~~~~~~~~~~~~~~~~~~~~~~~~~~~~~~~~~~~~~~~~~"
      ],
      "palettes": [ "standard_domestic_palette", "parameterized_linoleum_color_bathroom" ],
      "terrain": {
        "~": "t_open_air",
        "#": "t_adobe_brick_wall",
        "=": "t_shingle_flat_roof",
        "&": "t_shingle_flat_roof",
        "%": "t_gutter_drop",
        "-": "t_gutter",
        "Q": "t_floor"
      },
      "place_nested": [ { "chunks": [ "NC_res_roof_chunk_3X3" ], "x": [ 6, 11 ], "y": [ 9, 13 ] } ]
    }
  },
  {
    "method": "json",
    "om_terrain": [ [ "urban_5_5", "urban_5_6" ] ],
    "type": "mapgen",
    "object": {
      "fill_ter": "t_shingle_flat_roof",
      "rows": [
        "                                                ",
        "                                                ",
        "                                                ",
        "                                                ",
        "                                                ",
        "                                                ",
        "                         -----                  ",
        "               -----------...--------------     ",
        "               -..........................-     ",
        "               -..........................-     ",
        "               -.........&......N.........-     ",
        "               -..........................-     ",
        "               -..........................-     ",
        "               -..........................-     ",
        "               -...........X...=..........-     ",
        "               -..........................-     ",
        "               5..........................-     ",
        "               ------...----------...------     ",
        "                    -----        -----          ",
        "                                                ",
        "                                                ",
        "                                                ",
        "                                                ",
        "                                                "
      ],
      "palettes": [ "roof_palette" ],
      "terrain": { ".": "t_shingle_flat_roof" },
      "place_nested": [ { "chunks": [ "NC_res_roof_solar_4X4" ], "x": 37, "y": 12 } ]
    }
  },
  {
    "method": "json",
    "om_terrain": [ [ "urban_5_1_basement", "urban_5_2_basement" ] ],
    "type": "mapgen",
    "object": {
      "fill_ter": "t_thconc_floor",
      "rows": [
        "                                                ",
        "                                                ",
        "                                                ",
        "                                                ",
        "                                                ",
        "                  |||||||||||||||||||||||||     ",
        "                  |.......................|     ",
        "    |||||||||||||||.......................|     ",
        "    |..........%..........................|     ",
        "    |..........%..........................|     ",
        "    |..........%..........................|     ",
        "    |..........%..........................|     ",
        "    |..........%%%%.......................|     ",
        "    |..........+zz+.......................|     ",
        "    |..........%.<%.......................|     ",
        "    |..........%%%%.......................|     ",
        "    |..........%.z........................|     ",
        "    ||||||||||||z.........................|     ",
        "               |UUJ.gF....................|     ",
        "               ||||||||||||||.............|     ",
        "                            |.............|     ",
        "                            |||||||||||||||     ",
        "                                                ",
        "                                                "
      ],
      "palettes": [ "basement_empty" ]
    }
  }
]
